родственники
Mother	мама
Father	папа
Parents	родители
Wife	жена
Husband	муж
Son	сын
Daughter	дочь
Children	дети
Brother	брат
Sister	сестра
Siblings	родные братья или/и сестры
Cousins	двоюродные братья или сестры, также	родственники
Relatives	родственники
Aunt	тетя
Uncle	дядя
Nephew	племянник
Niece	племянница
Grandparents	бабушка и дедушка
Grandmother	бабушка
Grandfather	дедушка
Grandson	внук
Granddaughter	внучка
Grandchildren	внучата
In-laws (mother-in-law, brother-in-law etc.)	член семьи по супругу (теща, свекровь, зять, свояк и т.д.)
Spouse	супруг (супружеская пара)
Stepmother / Stepfather	мачеха / отчим
Stepson/stepdaughter	пасынок / падчерица
Stepsister / stepbrother	сводня сестра / сводный брат
Half—sister	сестра по одному из родителей
Half—brother	брат по одному из родителей

Глубокая посуда	Hollowware
Bread basket	хлебница
Carafe	графин
Soup bowl	супница
Butter dish	масленка
Sugar bowl	сахарница
Coffee cup	кофейная чашка
Sauce boat	соусник
Salt shaker	солонка
Pepper shaker	перечница
Oil cruet	графин для масла
Vinegar cruet	графин для уксуса
Coffee pot	кофейник
Tea pot	чайник, заварочный чайник
Milk jug	кувшин для молока
Cream jug	ковшик для крема, сливок
Water jug	кувшин для воды 
Статья в тему:
Кухонные предметы на английском языке
Виды посуды и столовые приборы на английском языке

Изображение взято с atailoredaffair.weebly.com 

Стеклянная посуда (бокалы, стаканы)	Glassware
Red wine glass	бокал для красного вина
Sherry glass	бокал для хереса (сорт крепкого виноградного вина)
White wine glass	бокал для белого вина
Water tumbler	стакан для воды
Ice-cream bowl	чаша для мороженного
Статья в тему:
18 забавных английских слов, которые имеют отношение к еде
Виды посуды и столовые приборы на английском языке

Изображение взято с izzz.com.au 

Столовое серебро и приборы
Dessert fork	десертная вилка
Fish fork	столовая вилка для рыбы
Table fork	столовая вилка
Butter knife	нож для масла
Fish knife	столовый нож для рыбы
Table knife	столовый нож
Soup ladle	половник
Sugar tongs	щипцы для сахара
Dessert spoon	ложка для десерта
Soup spoon	ложка для супа
Tea / coffee spoon	чайная ложка, кофейная ложка
Salad spoon	ложка для салата
Cake fork	вилка для торта
Статья в тему:
Инфографика: разновидности чая на английском + 6 английских «чайных» идиом
Фаянсовая и глиняная посуда	China and crockery
Bottom plate	подтарельник
Dinner / soup plate	глубокая тарелка
Side plate	вспомогательная тарелка
Saucer	блюдце
Другие предметы	Other items
Tablecloth	скатерть
Napkin	салфетка
Ash-tray	пепельница
Flower vase	ваза для цветов


Названия фруктов и ягод на английском языке
Юлия Грин
Этот автор	репетитор Preply!
Юлия Грин17.05.2016Время чтения: 2 мин.Обновлено 12.09.2022
Оглавление
Fruit	Фрукты
Berries	Ягоды

Изображение найдено на zastavki.com

Какой ваш любимый фрукт или ягода? А вы знаете как они называются на английском? Сегодня мы с вами выучим массу «вкусных» английских слов, а именно, названия фруктов и ягод на английском языке. Если вы хотите узнать больше новых интересных слов и пополнить свой словарный запас английского	читайте далее!

Fruit	Фрукты	
Berries	Ягоды	
Fruit	Фрукты	Фрукты
Apple 	[æpl]	яблоко	Фрукты
Apricot 	[æprɪkɑːt]	абрикос	Фрукты
Avocado 	[ævəˈkɑːdoʊ]	авокадо	Фрукты
Banana 	[bəˈnænə]	банан	Фрукты
Coconut 	[koʊkənʌt]	кокос	Фрукты
Fig 	[fɪɡ]	инжир	Фрукты
Kiwi (fruit) 	[kiːwiː]	киви	Фрукты
Lemon 	[lemən]	лимон	Фрукты
Lime 	[laɪm]	лайм	Фрукты
Mango 	[mæŋɡoʊ]	манго	Фрукты
Nectarine 	[nektəriːn]	нектарин	Фрукты
Orange 	[ɔːrɪndʒ]	апельсин	Фрукты
Papaya 	[pəˈpaɪə]	папайя	Фрукты
Passion fruit 	[pæʃn fruːt]	маракуйя, пассифлора	Фрукты
Peach 	[piːtʃ]	персик	Фрукты
Pear 	[per]	груша	Фрукты
Pineapple 	[paɪnæpl]	ананас	Фрукты
Plum 	[plʌm]	слива	Фрукты
Quince 	[kwɪns]	айва	Фрукты
Star fruit 	[stɑːr fruːt]	карамбола	Фрукты
Grapefruit 	[ɡreɪpfruːt]	грейпфрут	Фрукты
Guava 	[ɡwɑːvə]	гуава	Фрукты
Honeydew 	[hʌniˌduː]	белая мускатная дыня	Фрукты
Melon 	[melən]	дыня	Фрукты
Pomelo 	[pɑːməloʊ]	помелло	Фрукты
Cantaloupe 	[kæntəluːp]	мускусная дыня	Фрукты
Dragon fruit 	[dræɡən fruːt]	драконний фрукт, питахайя	Фрукты
Pomegranate 	[pɑːmɪɡrænɪt]	гранат	Фрукты
Persimmon 	[pərˈsɪmən]	хурма	Фрукты
Tangerine 	[tændʒəriːn]	мандарин	Фрукты
Berries	Ягоды	Ягоды
Black currant 	[blæk kɜːrənt]	смородина	Ягоды
Blackberry 	[blækberi]	эжевика	Ягоды
Blueberry 	[bluːberi]	брусника, голубика	Ягоды
Cherry 	[tʃeri]	вишня, черешня	Ягоды
Grapes 	[ɡreɪps]	виноград	Ягоды
Raspberry 	[ræzberi]	малина	Ягоды
Strawberry 	[strɔːberi]	клубника	Ягоды
Watermelon 	[wɔːtərmelən]	арбуз	Ягоды
Cranberry 	[krænberi]	клюква	Ягоды
Gooseberry 	[ɡuːsberi]	крыжовник	Ягоды
		
Vegetables	Овощи	Овощи
Potato 	[pəˈteɪtoʊ]	картофель	Овощи
Tomato 	[təˈmeɪtoʊ]	помидор	Овощи
Carrot 	[kærət]	морковь	Овощи
Cabbage 	[kæbɪdʒ]	капуста	Овощи
Pepper 	[pepər]	перец	Овощи
Hot / Chili pepper 	[hɑːt / tʃɪli pepər]	острый перец	Овощи
Eggplant 	[eɡplænt]	баклажан	Овощи
Cauliflower 	[kɔːliflaʊər]	цветная капуста	Овощи
Onion 	[ʌnjən]	лук	Овощи
Garlic 	[ɡɑːrlɪk]	чеснок	Овощи
Parsley 	[pɑːrsli]	петрушка	Овощи
Celery 	[seləri]	сельдерей	Овощи
Radish 	[ˈrædɪʃ]	редиска	Овощи
Cucumber 	[kjuːkʌmbər]	огурец	Овощи
Lettuce 	[letɪs]	салат-латук	Овощи
Pumpkin 	[pʌmpkɪn]	тыква	Овощи
Courgette 	[kʊrˈʒet]	кабачок	Овощи
Pea 	[piː]	горох	Овощи
Chick pea 	[tʃɪk piː]	нут обыкновенный	Овощи
Green beans 	[ɡriːn biːnz]	зеленая фасоль	Овощи
Asparagus 	[əˈspærəɡəs]	cпаржа	Овощи
Green onion 	[ɡriːn ʌnjən]	зеленый лук, лук-перо	Овощи
Broccoli 	[brɑːkəli]	капуста броколи	Овощи
Spinach 	[spɪnɪtʃ]	шпинат	Овощи
Corn 	[kɔːrn]	кукуруза	Овощи
Yam 	[jæm]	батат, сладкий картофель	Овощи
Beets 	[biːts]	свекла	Овощи
Turnip 	[tɜːrnɪp]	репа	Овощи
Ginger 	[dʒɪndʒər]	имбирь	Овощи


Говорим о еде на английском: актуальные слова для описания вкусовых ощущений
Юлия Грин
Этот автор	репетитор Preply!
Юлия Грин05.01.2016Время чтения: 2 мин.Обновлено 12.09.2022
Оглавление
Прилагательные для описания вкусовых особенностей еды
Степени прожарки мяса

Изображение взято с jackielede.com

В период праздничных и выходных дней вопрос еды особенно актуален. Еда повсюду, в супермаркетах, на улице, в ресторанах, кафе, по телевизору и в интернете. Это неотъемлемая часть нашей жизни.

Именно поэтому обсуждение еды и вкусовых ощущений так часто появляется в разговоре, причем, не только на родном языке, но и на английском. Всем нам иногда так хочется чего-то вкусненького, правда?

Сегодня предлагаю поговорить о еде на английском и выучить несколько актуальных слов для описания вкусовых ощущений и предпочтений.

Начнем с того, какая бывает еда в плане приготовления: сырая, острая, безвкусная и т.д.

Well done	хорошо приготовленная
Raw	сырая
Tasteless	безвкусная
Bland	безвкусная
Salty	соленая (пересоленная)
Bitter	горькая
Sour	кислая
Rancid	протухшая, прогорклая
Spicy	острая (много специй)
Tough	жесткая
Tender	мягкая, нежная
Piping hot	с пылу с жару, т.е. очень свежая (что-то горячее)
Статья в тему:
Виды посуды и столовые приборы на английском языке
Прилагательные для описания вкусовых особенностей еды
А теперь посмотрим на английские слова, с помощью которых можно описать еду и передать ваши ощущения от блюда.

Aromatic	ароматный
Appetizing	аппетитный
Nutritious	сытный
Palatable	вкусный, приятный, съедобный
Vinegary	с привкусом уксуса, уксусный
Gooey	липкий и сладкий, клейкий
Crumbly	рассыпчатый, крошащийся
Crunchy / crispy	хрустящий, с хрустящей корочкой
Spongy	тает во рту, невесомый, легкий «как губка», пористый
Greasy / oily	жирный
Статья в тему:
Как сказать «мне нравится» или «не нравится» на английском разными способами
Степени прожарки мяса
Для любителей мяса, и стейков в особенности, предлагаю запомнить несколько названий относительно степени приготовления этого блюда.

Rare	с кровью
Medium rare (med-rare)	слабой прожарки
Medium	средней прожарки
Medium well	почти прожаренный
Well done	прожаренный



Фразовые глаголы, которые стоит запомнить
Be out	отсутствовать
Be off	уезжать, уходить, быть неработающим, свободным
Be over	завершиться, окончиться
Beupto	намереваться, собираться что-то сделать, зависеть от
Break in	вламываться, врываться, вмешиваться (в разговор)
Break down	сломаться, сломать, выйти из строя
Calm down	успокаиваться, успокаивать
Call back	перезвонить, позвать назад
Carry on	продолжать заниматься чем-то
Check in	регистрироваться, зарегистрировать
Check out	выписаться из, выяснять, проверять
Clean up	убирать, приводить в порядок
Come along	приходить, появляться, идти вместе, сопровождать
Come across	случайно встретить, натолкнуться на
Come from	происходить от / из, взяться
Come on	приходить, проходить, давай! / брось! /пошли! /кончай!
Come in	входить, прибывать, приходить
Come over	заезжать, подходить, приходить, охватывать
Cut off	отрезать, прерывать
Count on	рассчитывать на, возлагать надежду
End up	закончить, попасть, оказаться
Статья в тему:
9 фразовых глаголов английского языка, связанных с вечеринками
Fall down	упасть, падать, рухнуть
Figure out	выяснить, сообразить, понять, разобраться
Find out	найти, обнаружить, выяснить, разузнать
Get away	уходить, удрать, ускользнуть
Get down	опустить, опуститься
Get in	забраться в, проникнуть, войти
Get off	покидать, выходить, уносить, удалять, уходи!
Get on	садиться на / в, продолжить, приступить к
Get out	выходить, вытаскивать, уходить
Get up	вставать, просыпаться
Go away	уезжать, уходить
Go off	убегать, улетать, уходить, уезжать
Go in	входить
Go on	продолжать, происходить, продолжайте!
Go through	пройти через, тщательно изучать, повторять
Grow up	вырастать, становиться взрослым
Статья в тему:
55 английских глаголов, которые нужно знать для «выживания»
Hang on	цепляться, хвататься, полагаться, рассчитывать на кого-то
Help out	помогать, выручать
Hold on	продолжать дело, несмотря на трудности, подождите! Оставайтесь на линии!
Keep up	продолжать, не отставать, поддерживать
Keep on	продолжать
Knock down	сносить, разрушать, сбить с ног
Let in	впускать
Lie down	прилечь, лечь
Line up	становиться в линию, ряд, очередь
Look back	оборачиваться, оглядываться
Look forward to	ожидать чего-то с нетерпением
Look for	искать, присматривать
Move on	продолжать движение, идти дальше
Move in	входить, въезжать (поселяться)
Pass out	терять сознание, раздавать
Pick up	подобрать, подхватить, взять, поднять (любой предмет, сигнал, человека, запах и т.д.)
Pull on	тянуть (на себя), натягивать (надевать)
Put in	вставлять
Put on	одевать, надевать, включать
Put down	опустить, положить
Put up	строить, поднимать, финансировать
Статья в тему:
8 фразовых глаголов английского языка для выражения состояния злости
Run out	истощаться, кончаться, выбегать
Run into	столкнуться, встретить, наскочить
Run over	переехать, задавить, столкнуться
Run away– удирать, убегать
Set up	создавать, организовывать, устраивать
Show up	приходить, появляться
Settle down	поселяться, успокаиваться, усаживаться
Sit down	садиться, успокаиваться, поселяться
Shut up	заткнуть, заставить замолчать, заткнись!
Shut down	выключить, отключить, закрыть
Stand by	приготовиться, поддерживать, ждать
Switch on	включать
Switch off –выключать
Take away	забирать, убирать, отнимать
Take off	уходить, уезжать, снимать с себя
Take in	приютить, впустить, воспринимать, вбирать
Throw up	тошнить, рвать, поднять, выкинуть, вскинуть
Статья в тему:
8 фразовых глаголов делового английского языка
Turn around	оборачиваться
Turn into	превращаться в кого-то или во что-то
Turn on	включать
Turn off	выключать, поворачивать, сворачивать
Turn out	выясниться, оказаться, получиться
Wake up	просыпаться, будить
Walk in	входить
Walk out	спланировать, разобраться, понять
Walk away– уходить
Walk off	уходить
Walk up	подходить
Work out	тренироваться, понять, разобраться, спланировать
Write down	записывать
Work up	создать, выработать, расстраиваться
Watch out	быть начеку, остерегаться

Названия офисной мебели
Office chair	офисный стул / кресло
Desk	письменный стол
Filing cabinet	шкаф
Bookshelf	книжная полка
Table lamp	настольная лампа
Coat wardrobe	шкаф для верхней одежды
office furniture

Статья в тему:
18 названий офисных предметов на английском языке, которые должен знать каждый
Названия видов окон, которые могут быть в вашем доме
Double / single hung window	двойное навесное окно
Single casement window	одностворчатое окно (может быть глухим или открывающимся)
Double casement window	окно с двумя створками
Picture window	окно с глухой створкой
Sliding patio doors	раздвижные двери внутреннего дворика
Circle window	круглое окно
Hexagon window	шестигранное окно
Half moon window	окно-полумесяц
Triangle window	треугольное окно
Screen	ветровое стекло, экран
types of windows

Статья в тему:
Как запоминать новые английские слова
Разновидности кроватей по-английски
Cradle	колыбель
Cot / crib	детская кроватка
Travel cot	«дорожная» детская кроватка
Divan	диван
Four—posterbed	кровать с балдахином
Futon	футон (японский матрас для сна)
Single bed	односпальная кровать
Bunk beds	двухъярусные кровати
Sofa bed	диван-кровать
Camp bed (cot) / sleeping bag	легкая походная кровать / спальный мешок
Airbed/ air mattress	надувная кровать / матрас
Hammock	гамак
types of beds

Статья в тему:
Учим английские слова: названия тканей на английском языке
Виды стульев на английском
Chair	стул
Armchair	кресло
Rocking chair	кресло-качалка
Stool	табурет
Car seat	автомобильное кресло
Wheelchair	инвалидное кресло
Swivel chair	вращающийся стул
Deckchair	шезлонг
Chaise longue	лежак
Lounger/ recliner	кресло для отдыха
High chair	детский стул
Director’s chair	режиссерское кресло
Bench	скамейка
Sofa	диван, софа
types of chairs

Статья в тему:
Кухонные предметы на английском языке
Предметы и мебель ванной комнаты
Wash tube	ванна
Wash basin	умывальник
WC (water closet)	туалет
Toilet paper	туалетная бумага
Toilet paper holder	держатель для туалетной бумаги
Liquid soap	жидкое мыло
Soap	мыло
Soap holder	мыльница
Towel	полотенце
Shower stall	душевая кабина
Faucet	кран
Dustpan & broom	совок и веник
Cleaning tools	моющие средства